person: человек, личность, индивид, персона, субъект, гражданин, особа
bicycle: велосипед, вести, байк, двухколесный транспорт, веломашина
car: автомобиль, машина, авто, транспортное средство, легковушка
motorcycle: мотоцикл, мотобайк, байк, мотор
airplane: самолёт, авиалайнер, воздушное судный, аэроплан, реактивный самолёт
bus: автобус, транспортное средство, маршрутка, общественный транспорт, автобусный транспорт
train: поезд, железнодорожный транспорт, локомотив, состав, электричка
truck: грузовик, грузовая машина, фура, тягач, автопоезд
boat: лодка, судно, катер, шлюпка, баркас
traffic light: светофор, световой сигнал, регулировщик движение, сигнальный фонарь, дорожный свет
fire hydrant: пожарный гидрант, водоразборная колонка, водопроводный кран, противопожарный кран, пожарный водоисточник
stop sign: знак стоп, знак остановка, дорожный знак, знак запрета движение
parking meter: паркометр, счетчик парковка, парковочный автомат
bench: скамейка, лавочка, сидение, скамья, место для сидение
bird: птица, пернатый, крылатое существо, птичка
cat: кошка, кот, мурка, пушистик, мурлыка
dog: собака, пёс, щенок, четвероногий друг, питомец
horse: лошадь, конь, жеребец, скакун, кобыла
sheep: овца, баран, ягнёнок, барашек, овечка
cow: корова, бурёнка, рогатое животный, бычок, телок
elephant: слон, слоник, гигантское животный, серый великать
bear: медведь, мишка, бурый зверить, косолапый
zebra: зебра, полосатая лошадь, экзотическое животный
giraffe: жираф, длинношеее животный, экзотическое животный
backpack: рюкзак, заплечный мешок, ранец, сумка
umbrella: зонт, зонтик, навес, парасолька
handbag: сумочка, дамская сумка, кошелёк, клатч
tie: галстук, шейный платка, узел, связь
suitcase: чемодан, багаж, дорожная сумка, кейс
frisbee: фрисби, летающая тарелка, дискообразная игрушка
skis: лыжа, горнолыжное снаряжение, лыжный инвентарь
snowboard: сноуборд, доска для снег, сноубордический инвентарь
sports ball: спортивный мяч, мяч для игра, игровой мяч
kite: воздушный змея, бумажный змея, летающая игрушка
baseball bat: бейсбольная бить, спортивная бить, деревянная палка
baseball glove: бейсбольная перчатка, спортивная перчатка, ловушка
skateboard: скейтборд, доска для катание, скейт
surfboard: доска для серфинг, серф, доска
tennis racket: теннисная ракетка, спортивная ракетка, ракетка для теннис
bottle: бутылка, флакон, сосуд, ёмкость
wine glass: бокал для вина, фужер, рюмка, винный бокал
cup: чашка, кружка, стаканчик
fork: вилка, прибор, вилочка
knife: нож, режущий инструмент, клинок
spoon: ложка, черпак, столовый прибор
bowl: миска, чаша, тарелка
banana: банан, тропический фрукт
apple: яблоко, фрукт, плодовое дерево
sandwich: сэндвич, бутерброд, бутереть
orange: апельсин, цитрус, фрукт
broccoli: брокколи, капуста, овощ
carrot: морковь, корнеплод, овощ
hot dog: хот-дог, сосиска в тест, фастфуд
pizza: пицца, итальянское блюдо, фастфуд
donut: пончик, сладость, пышка
cake: торт, пирог, выпечка, десерт
chair: стул, сидение, кресло
couch: диван, софа, кушетка, мягкая мебель
potted plant: комнатное растение, цветок в горшок, зелень
bed: кровать, ложа, спальное место
dining table: обеденный стола, стол для ед, кухонный стола
toilet: туалет, унитаз, санузел
tv: телевизор, тв, экран
laptop: ноутбук, портативный компьютер, лэптоп
mouse: мышь, компьютерная мышка, указатель
remote: пульт, пульт дистанционного управление, дистанционный контроллер
keyboard: клавиатура, клавишный инструмент
cell phone: мобильный телефон, сотовый телефон, мобилка, смартфон
microwave: микроволновка, печь, кухонный прибор
oven: духовка, печь, плита
toaster: тостер, кухонный прибор, гриль
sink: раковина, мойка, умывальник
refrigerator: холодильник, морозильник, холодильная камера
book: книга, печатное издание
clock: часы, хронометр, таймер
vase: ваза, сосуд, цветочная емкость
scissors: ножницы, резак, режущий инструмент
teddy bear: плюшевый мишко, игрушка, мягкий мишко
hair drier: фен, сушилка для волосый, прибор для сушки волосый
toothbrush: зубная щетка, средство гигиена, щётка