person: человек, индивид, личность, особа, персона
bicycle: велосипед, двухколесный
car: автомобиль, машина, авто
motorcycle: мотоцикл, байк, мото
airplane: самолёт, авиалайнер, воздушное судно
bus: автобус, пассажирский автобус, маршрутка
train: поезд, железнодорожный состав, пассажирский поезд
truck: грузовик, фура, грузовой автомобиль
boat: лодка, судно, маломерное судно
traffic light: светофор, дорожный светофор
fire hydrant: пожарный гидрант, гидрант
stop sign: знак стоп, стоп-знак
parking meter: парковочный счетчик, паркомат
bench: скамейка, парковая скамейка
bird: птица, пернатый
cat: кошка, кот
dog: собака, пёс
horse: лошадь, конь
sheep: овца, баран
cow: корова, бык
elephant: слон, бивень
bear: медведь, зверь
zebra: зебра, полосатый
giraffe: жираф, длинношеее
backpack: рюкзак, наплечный мешок
umbrella: зонтик, дождевик
handbag: сумка, дамская сумка
tie: галстук, шейный платок
suitcase: чемодан, багаж
frisbee: фрисби, летающий диск
skis: лыжа, горные лыжи
snowboard: сноуборд, доска для сноуборда
sports ball: спортивный мяч, мяч
kite: змея, воздушный змей
baseball bat: бейсбольная бита, бита
baseball glove: бейсбольная перчатка, перчатка для бейсбола
skateboard: скейтборд, скейт
surfboard: доска для серфинга, серф
tennis racket: теннисная ракетка, ракетка
bottle: бутылка, флакон
wine glass: винный бокал, бокал для вина
cup: чашка, кружка
fork: вилка, столовый прибор
knife: нож, кухонный нож
spoon: ложка, столовая ложка
bowl: тарелка, миска
banana: банан, плод
apple: яблоко, фрукт
sandwich: сэндвич, бутерброд
orange: апельсин, цитрус
broccoli: брокколи, зелень
carrot: морковь, овощ
hot dog: хот-дог, сосиска в булке
pizza: пицца, итальянское блюдо
donut: пончик, кольцевой пирог
cake: торт, десерт
chair: кресло, стул
couch: диван, канапе
potted plant: растение в горшке, комнатное растение
bed: кровать, постель
dining table: обеденный стол, стол
toilet: туалет, уборная
tv: телевизор, телеаппарат
laptop: ноутбук, переносной компьютер
mouse: компьютерная мышь, мышь
remote: пульт, дистанционное управление
keyboard: клавиатура, компьютерная клавиатура
cell phone: сотовый телефон, мобильный телефон
microwave: микроволновка, микроволновая печь
oven: печь, духовка
toaster: тостер, прибор для тостов
sink: кран, мойка
refrigerator: холодильник, холодильное устройство
book: книга, том
clock: часы, временной прибор
vase: ваза, цветочный сосуд
scissors: ножницы, режущий инструмент
teddy bear: медвежонок, плюшевый медведь
hair drier: фен, сушилка для волос
toothbrush: зубная щетка, щетка для зубов
airport inside: аэропорт внутри, внутреннее пространство аэропорта
artstudio: художественная студия, мастерская художника
auditorium: аудитория, зал для зрителей
bakery: пекарня, хлебопекарня
bookstore: книжный магазин, магазин книг
bowling: боулинг, боулинг-клуб
buffet: буфет, столовая
casino: казино, игорный дом
children room: детская комната, комната для игр
church inside: внутри церковь, интерьер церкви
classroom: класс, учебная аудитория
cloister: монастырь, клостер
closet: шкаф, гардеробная
clothingstore: магазин одежды, бутик
computerroom: компьютерный зал, зал компьютеров
concert hall: концертный зал, музыкальный зал
corridor: коридор, проход
deli: гастроном, делликатесный магазин
dentaloffice: стоматологическое отделение, стоматология
dining room: столовая, обеденная комната
elevator: лифт, подъемник
fast food restaurant: ресторан быстрого питания, фастфуд
florist: флорист, цветочный магазин
game room: игровой зал, зал для игр
garage: гараж, автогараж
greenhouse: теплица, парник
grocery store: продуктовый магазин, магазин продуктов
gym: спортзал, тренажерный зал
hair salon: парикмахерская, салон красоты
hospital room: палата в госпитале, больничная палата
inside bus: внутри автобуса, салон автобуса
inside subway: внутри метро, вагон метро
jewellery shop: ювелирный магазин, магазин ювелирных изделий
kindergarten: детский сад, дошкольное учреждение
kitchen: кухня, кулинарное пространство
laboratory wet: влажная лаборатория, экспериментальная лаборатория
laundromat: прачечная самообслуживания, автоматическая прачечная
library: библиотека, книжный фонд
living room: гостиная, зал
lobby: лобби, вестибюль
locker room: раздевалка, комната для переодевания
mall: торговый центр, молл
meeting room: зал заседаний, конференц-зал
movie theater: кинотеатр, кинозал
museum: музей, выставочный зал
nursery: ясли, детская комната
office: офис, рабочее пространство
operating room: операционная, хирургический зал
pantry: кладовая, запасная комната
pool inside: внутренний бассейн, крытый бассейн
prison cell: тюремная камера, камера заключения
restaurant: ресторан, общепит
restaurant kitchen: кухня ресторана, кулинарное отделение ресторана
shoe shop: обувной магазин, магазин обуви
staircase: лестница, лестничный пролет
studio music: музыкальная студия, студия звукозаписи
subway: метро, подземка
toy store: магазин игрушек, магазин детских товаров
train station: железнодорожная станция, вокзал
tv studio: телевизионная студия, студия ТВ
video store: видеомагазин, магазин видеофильмов
waiting room: приемная, зал ожидания
warehouse: склад, хранилище
wine cellar: винный погреб, винотека
airport: аэропорт, воздушная гавань
alley: переулок, узкая улица
beach: пляж, морской берег
bridge: мост, переправа
campsite: кемпинг, палаточный лагерь
canyon: каньон, ущелье
cemetery: кладбище, некрополь
church: церковь, храм
city: город, мегаполис
cliff: обрыв, скала
coast: побережье, берег моря
construction site: стройплощадка, строительная площадка
dam: плотина, дамба
desert: пустыня, безводная зона
farm: ферма, хозяйство
festival: фестиваль, праздник
field: поле, простор
forest: лес, лесной массив
fortress: крепость, форт
garden: сад, парк
glacier: ледник, глетчер
harbor: гавань, порт
hills: холмы, возвышенности
island: остров, островной район
jungle: джунгли, тропический лес
lake: озеро, водоем
lighthouse: маяк, башня с огнем
mine: шахта, копь
mosque: мечеть, исламский храм
mountain: гора, горный хребет
observatory: обсерватория, астрономическая станция
orchard: фруктовый сад, сад с деревьями
palace: дворец, резиденция
park: парк, зеленая зона
plantation: плантация, культурный насаждение
port: порт, морской терминал
race track: гоночная трасса, автодром
railway: железная дорога, железнодорожные пути
river: река, водоток
road: дорога, шоссе
ruins: руины, развалины
savanna: саванна, тропическая равнина
square: площадь, городская площадь
stadium: стадион, спортивная арена
street: улица, дорожка
suburb: пригород, окраина
swamp: болото, топь
temple: храм, святилище
town: городок, населенный пункт
train station: железнодорожная станция, вокзал
tundra: тундра, полярная равнина
tunnel: туннель, подземный проход
underwater: подводный, под водой
valley: долина, ущелье
village: деревня, поселок
volcano: вулкан, гора с кратером
waterfall: водопад, падающая вода
wind farm: ветряная ферма, ветропарк
windmill: ветряная мельница, ветряк
zoo: зоопарк, парк диких животных
interior: интерьер, внутреннее пространство, инт
nature: нат, природа, свежий воздух
